R 1080 1000
NO ./textures/redbrick.xpm
SO ./textures/wood.xpm
WE ./textures/wood.xpm
S ./textures/barrel.xpm
C 255,200,160
F 122,122,122
EA ./textures/greystone.xpm


11111111111111111
100E0000000000001
10200000200000201
10000000000000001
10202000000000021
10000100000100001
10202020002020201
10000000000000001
10002000200200001
10000000000000001
10200000200002001
10000000000000001
10000000000000001
10000000000000001
10000000000000001
11111111111111111
