NO ./textures/grass.xpm
SO ./textures/brick.xpm
WE ./textures/sky.xpm
EA ./textures/stone.xpm
S ./textures/tom_nook.xpm
S2 ./textures/tom_nook.xpm
C 135,206,235
F 179,139,109
R 2000 2000



1111
10N1
1001
1111
