R 2000 2000
NO ./textures/stone.xpm
SO ./textures/stone.xpm
WE ./textures/brick.xpm
EA ./textures/grass.xpm
S ./textures/tom_nook_beau.xpm
S2 ./textures/clochettes.xpm
C ./textures/sky.xpm
F ./textures/floor_ac.xpm



11111111111111111
10000000000000001
10000000000000001
10000000000000001
10000000000000001
10000100000100001
10000000000000001
10000000300000001
10000022320000001
10000000200000001
10000000000000001
10000000000000001
10000000000000001
100000000W0000001
10000000000000001
11111111111111111
