R 2000 2000
NO ./textures/stone.xpm
SO ./textures/stone.xpm
WE ./textures/brick.xpm
EA ./textures/grass.xpm
S ./textures/tom_nook_beau.xpm
S2 ./textures/clochettes.xpm
C 225,0,00
F ./textures/floor_ac.xpm



11111111111111111
100000000000000W1
10111111111111111
10000000000000001
11111111111111101
10000200000200001
10000000000000001
10111111111111111
10000000000000111
10000000000000031
10000000000000111
10000000000000001
11100000000000001
13000000000000001
11100000000000001
11111111111111111
