R 2000 2000
NO ./textures/brick.xpm
SO ./textures/brick.xpm
WE ./textures/brick.xpm
EA ./textures/brick.xpm
S1 ./textures/plant_mario.xpm
S2 ./textures/plant_mario.xpm
C 135,206,235
F 179,139,109



11111111111111111
100W0000000000001
10200000200000201
10000000000000001
10202000000000021
10000100000100001
10202020003020201
10000000000000001
10002000200200001
10000000000000001
10200000200002001
10000000000000001
10000000000000001
10000000000000001
10000000000000001
11111111111111111
