C ./textures/night_sky.xpm
R 2000 2000
NO ./textures/water.xpm
SO ./textures/Iceberg.xpm
WE ./textures/snow2.xpm
EA ./textures/snow2.xpm
S ./textures/scary_white_walker.xpm
S2 ./textures/beer.xpm
F ./textures/icelake.xpm

1111111111
1000000001
100N000001
1003000001
1000000001
1000000001
1000000001
1111111111

 
