R 2000 2000
NO ./textures/stone.xpm
SO ./textures/stone.xpm
WE ./textures/brick.xpm
EA ./textures/grass.xpm
S ./textures/scary_white_walker.xpm
S2 ./textures/beer_2.xpm
C ./textures/sky.xpm
F ./textures/stone.xpm



11111111111111111
10000000000000001
10000000000000201
10000000000000001
10000000000000001
10000100000100001
10000000003000001
10000000000000001
10000000000000001
10000000000000001
10000000000000001
10000000000000001
10000000000000001
100000000W0000001
10000000000000001
11111111111111111
