
C 255,20,30
R 2000 2000
NO ./textures/brick.xpm
SO ./textures/sky.xpm
WE ./textures/brick.xpm
EA ./textures/brick.xpm
S ./textures/scary_white_walker.xpm
S2 ./textures/beer.xpm
F ./textures/icelake.xpm

11111111111111111
100000000000000W1
10111111111111111
10000000000000001
10111111111111111
10000000000000001
10111111111111111
10111111111111111
10111111111111111
10111111111111111
10111111111111111
10111111111111111
10111111111111111
10111111111111111
10111111111111111
10111111111111111
10111111111111111
10111111111111111
10111111111111111
10111111111111111
10111111111111111
10111111111111111
10111111111111111
10111111111111111
10000000000000001
10111111111111111
10000000000000001
10000000000000001
10111111111111111
10000000000000001
10000000000000001
10111111111111111
10000000000000001
10000000000000001
10111111111111111
10000000000000001
10000000000000001
10111111111111111
10000000000000001
10000000000000001
10111111111111111
10000000000000001
10000000000000001
10111111111111111
10000000000000001
10000000000000001
10111111111111111
10000000000000001
10000000000000001
10111111111111111
10000000000000001
10000000000000001
10111111111111111
10000000000000001
10000000000000001
10111111111111111
10000000000000001
10000000000000001
10111111111111111
10000000000000001
10000000000000001
10000000000000001
10000000000000001
10000000000000001
10000000000000001
10111111111111111
10000000000000001
10000000000000001
10111111111111111
10000000000000001
10000000000000001
10000000000000001
10111111111111111
10000000000000001
10000000000000001
10111111111111111
10000000000000001
10000000000000001
10000000000000001
10111111111111111
10000000000000001
10000000000000001
10111111111111111
10000000000000001
10000000000000001
10000000000000001
11111111111111111
