C ./textures/night_sky.xpm
R 1000 1000
NO ./textures/water.xpm
SO ./textures/Iceberg.xpm
WE ./textures/snow2.xpm
EA ./textures/snow2.xpm
S ./textures/scary_white_walker.xpm
S2 ./textures/beer.xpm
F ./textures/icelake.xpm

   1111111111111111111111111
   1200000020110000000000001
   101100020011020W000000001
111111111111000000000000011111111111
111111111011000001110000000000001
100000000011000001110111111111111
11110111111111011100000010001
11110111111111011101010010001
11000000110101011100000010001
10002000000000001101000010001
10000000030000001101010000001
11000001110101011110111100111
11110111 1110101 101111010001
11111111111111111111111111111
