R 600 600
NO ./textures/water.xpm
SO ./textures/Iceberg.xpm
WE ./textures/snow2.xpm
EA ./textures/snow2.xpm
S ./textures/scary_white_walker.xpm
S2 ./textures/beer.xpm
F 57,57,57
C ./textures/night_sky.xpm

1111111111111111111111111111111111111111111111111111111111111111111111111111111111111111111111111111111111111111111
100020001
100300001 
1000W0001
100020001
100020001
100020001
100020001
100020001
100020001
100020001
100020001
100020001
100020001
100020001
100020001
100020001
100020001
100020001
100020001
100020001
100020001
100020001
100020001
100020001
100020001
100020001
100020001
100020001
100020001
100020001
100020001
100020001
100020001
100020001
100020001
100020001
100020001
100020001
100020001
100020001
100020001
100020001
100020001
100020001
100020001
100020001
100020001
100020001
100020001
100020001
100020001
100020001
100020001
100020001
100020001
100300001 
100300001 
111111111
