R 2000 2000
NO ./textures/grass.xpm
SO ./textures/grass.xpm
WE ./textures/sky.xpm
EA ./textures/grass.xpm
S ./textures/tom_nook.xpm
S2 ./textures/tom_nook.xpm
C 135,206,235
F 179,139,109



11111111111111111
10000000000000001
10000000000000001
10000000000000001
10000000000000001
10000100000100001
10000000002000001
10000000W00000001
10000000000000001
10000000000000001
10000000000000001
10000000000000001
10000000000000001
10000000000000001
10000000000000001
11111111111111111
