C 255,0,30
R 2000 2005
NO ./textures/brick.xpm
SO ./textures/sky.xpm
WE ./textures/brick.xpm
EA ./textures/brick.xpm
S ./textures/scary_white_walker.xpm
F ./textures/icelake.xpm

1111111111111111
1000000000000001
10111111111111111
100000000W0000001
10002000000000001
10000200002000001
10111111111111111
 1
