C 255,20 ,30
R  2147483647 2147483647
NO      ./textures/eagle.xpm
SO ./textures/greystone.xpm
EA ./textures/red.xpm
WE ./textures/purplestone.xpm
S ./textures/tonneau.xpm
F  000, 000, 00





1111111111111111101111111111101
1111111110002000000000000111111
10000000000000000011100010000111
1100001000000000000000000011111
1000011111110000000200001111111
1111111000000000W0000000000001111
1111000000000011000001
111100000000000000000000000001
110000000000011110000000000011
100000000000111000000000000011
110000000000111000000000001111
11000000000111100000000000011111111111
111111111111111111111111111111
