C 255,20,30
R   800 500
NO      ./textures/eagle.xpm
SO ./textures/greystone.xpm
EA ./textures/red.xpm
WE ./textures/purplestone.xpm
S ./textures/tonneau.xpm
F  0, 000, 00

   1111111111111111111111111
   100W000000110000000000001
   1011000001110000002000001
111111111111000000000000011111111111
111111111011000001110000000000001
100000000011000001110111111111111
11110111111111011100000010001
11110111111111011101010010001
11000000110101011100000010001
10002000000000001101000010001
10000000000000001101010000001
11000001110101011110111100111
11110111 1110101 101111010001
11111111111111111111111111111
