R 1080 1080
NO ./textures/redbrick.xpm
SO ./textures/wood.xpm
WE ./textures/wood.xpm
S ./textures/barrel.xpm
C 255,200,160
F 122,122,122
EA ./textures/greystone.xpm


1111111111111111111111111
1000000000110000000000001
1011000001110000002000001
1111111111110000000000001
111111110110000S11100001
1000000000011000111111111
1111111111111100000010001
1111011111111101010010001
1100000011010100000010001
1000200010010001000010001
1000000010001001010000001
1100000111010101111000111
1111011101110101111010001
1111111111111111111111111
