R 100 720
NO ./textures/redbrick.xpm
SO ./textures/wood.xpm
WE ./textures/wood.xpm
S ./textures/barrel.xpm
C 255,200,160
F 122,122,122
EA ./textures/greystone.xpm


11111111111
10000000001
10000000W01
10000000001
11111111111
